1111111111111111111111
1C000000011111111C00E1
111110000100000C100001
1000100001000000100001
1000111001111000100001
1000000000001000100001
1011111110001000100001
100000001000100C100001
100C000011110001000001
1001111000000010000001
1000001111100010000001
1111000000110011110001
1000000000110000000001
1000111000110111111001
1000000000000000000001
1000000111111100000001
1P000000000000000000C1
1111111111111111111111