111111
1P0C01
100001
1C0E01
1C0001
111111
