111111
1P0001
100C01
100011
10E0C1
111111
