1111111
1P00001
100C0C1
1C0E001
1000001
1111111
